000000001
000000002
000000003
000000004
000000005
000000006
000000007
000000008
000000009
000000010
000000011
000000012
000000013
000000014
000000015
000000016
000000017
000000018
000000019
000000020
000000021
000000022
000000023
000000024
000000025
000000026
000000038
000000044
000000048
000000072
000000075
